"filename", "language", "JavaScript", "XML", "JavaScript React", "CSS", "comment", "blank", "total"
"/Users/brijeshlakkad/Documents/Concordia Code/Fall 2022/SOEN 6841 Software Project Management/Projects/medical-assistance-web/src/App.css", "CSS", 0, 0, 0, 0, 0, 1, 1
"/Users/brijeshlakkad/Documents/Concordia Code/Fall 2022/SOEN 6841 Software Project Management/Projects/medical-assistance-web/src/App.js", "JavaScript", 67, 0, 0, 0, 1, 8, 76
"/Users/brijeshlakkad/Documents/Concordia Code/Fall 2022/SOEN 6841 Software Project Management/Projects/medical-assistance-web/src/App.test.js", "JavaScript", 7, 0, 0, 0, 0, 2, 9
"/Users/brijeshlakkad/Documents/Concordia Code/Fall 2022/SOEN 6841 Software Project Management/Projects/medical-assistance-web/src/RouteGuard.js", "JavaScript", 25, 0, 0, 0, 1, 5, 31
"/Users/brijeshlakkad/Documents/Concordia Code/Fall 2022/SOEN 6841 Software Project Management/Projects/medical-assistance-web/src/components/assessment-form/assessment-form.css", "CSS", 0, 0, 0, 65, 1, 10, 76
"/Users/brijeshlakkad/Documents/Concordia Code/Fall 2022/SOEN 6841 Software Project Management/Projects/medical-assistance-web/src/components/assessment-form/assessment-form.jsx", "JavaScript React", 0, 0, 44, 0, 0, 3, 47
"/Users/brijeshlakkad/Documents/Concordia Code/Fall 2022/SOEN 6841 Software Project Management/Projects/medical-assistance-web/src/components/boolean-radio-group/boolean-radio-group.jsx", "JavaScript React", 0, 0, 47, 0, 0, 3, 50
"/Users/brijeshlakkad/Documents/Concordia Code/Fall 2022/SOEN 6841 Software Project Management/Projects/medical-assistance-web/src/components/box/box.jsx", "JavaScript React", 0, 0, 112, 0, 21, 3, 136
"/Users/brijeshlakkad/Documents/Concordia Code/Fall 2022/SOEN 6841 Software Project Management/Projects/medical-assistance-web/src/components/cards/card-content.css", "CSS", 0, 0, 0, 70, 1, 15, 86
"/Users/brijeshlakkad/Documents/Concordia Code/Fall 2022/SOEN 6841 Software Project Management/Projects/medical-assistance-web/src/components/cards/card-content.jsx", "JavaScript React", 0, 0, 23, 0, 0, 1, 24
"/Users/brijeshlakkad/Documents/Concordia Code/Fall 2022/SOEN 6841 Software Project Management/Projects/medical-assistance-web/src/components/cards/card-image.jsx", "JavaScript React", 0, 0, 36, 0, 0, 2, 38
"/Users/brijeshlakkad/Documents/Concordia Code/Fall 2022/SOEN 6841 Software Project Management/Projects/medical-assistance-web/src/components/cards/card-otheruser.css", "CSS", 0, 0, 0, 49, 0, 9, 58
"/Users/brijeshlakkad/Documents/Concordia Code/Fall 2022/SOEN 6841 Software Project Management/Projects/medical-assistance-web/src/components/cards/card-otheruser.jsx", "JavaScript React", 0, 0, 39, 0, 0, 1, 40
"/Users/brijeshlakkad/Documents/Concordia Code/Fall 2022/SOEN 6841 Software Project Management/Projects/medical-assistance-web/src/components/cards/card.jsx", "JavaScript React", 0, 0, 16, 0, 0, 1, 17
"/Users/brijeshlakkad/Documents/Concordia Code/Fall 2022/SOEN 6841 Software Project Management/Projects/medical-assistance-web/src/components/counselor-login/counselor-login.jsx", "JavaScript React", 0, 0, 63, 0, 0, 8, 71
"/Users/brijeshlakkad/Documents/Concordia Code/Fall 2022/SOEN 6841 Software Project Management/Projects/medical-assistance-web/src/components/counselor-reject-patient/counselor-reject-patient.css", "CSS", 0, 0, 0, 0, 0, 1, 1
"/Users/brijeshlakkad/Documents/Concordia Code/Fall 2022/SOEN 6841 Software Project Management/Projects/medical-assistance-web/src/components/counselor-reject-patient/counselor-reject-patient.jsx", "JavaScript React", 0, 0, 7, 0, 0, 2, 9
"/Users/brijeshlakkad/Documents/Concordia Code/Fall 2022/SOEN 6841 Software Project Management/Projects/medical-assistance-web/src/components/counselor-signup/counselor-signup.jsx", "JavaScript React", 0, 0, 213, 0, 6, 22, 241
"/Users/brijeshlakkad/Documents/Concordia Code/Fall 2022/SOEN 6841 Software Project Management/Projects/medical-assistance-web/src/components/doctor-login/doctor-login.jsx", "JavaScript React", 0, 0, 63, 0, 0, 6, 69
"/Users/brijeshlakkad/Documents/Concordia Code/Fall 2022/SOEN 6841 Software Project Management/Projects/medical-assistance-web/src/components/doctor-signup/doctor-signup.jsx", "JavaScript React", 0, 0, 214, 0, 6, 23, 243
"/Users/brijeshlakkad/Documents/Concordia Code/Fall 2022/SOEN 6841 Software Project Management/Projects/medical-assistance-web/src/components/elements/error-message.js", "JavaScript", 8, 0, 0, 0, 0, 1, 9
"/Users/brijeshlakkad/Documents/Concordia Code/Fall 2022/SOEN 6841 Software Project Management/Projects/medical-assistance-web/src/components/elements/prepare-message.js", "JavaScript", 8, 0, 0, 0, 0, 1, 9
"/Users/brijeshlakkad/Documents/Concordia Code/Fall 2022/SOEN 6841 Software Project Management/Projects/medical-assistance-web/src/components/elements/success-message.js", "JavaScript", 8, 0, 0, 0, 0, 1, 9
"/Users/brijeshlakkad/Documents/Concordia Code/Fall 2022/SOEN 6841 Software Project Management/Projects/medical-assistance-web/src/components/footer/footer.css", "CSS", 0, 0, 0, 18, 0, 3, 21
"/Users/brijeshlakkad/Documents/Concordia Code/Fall 2022/SOEN 6841 Software Project Management/Projects/medical-assistance-web/src/components/footer/footer.jsx", "JavaScript React", 0, 0, 9, 0, 0, 3, 12
"/Users/brijeshlakkad/Documents/Concordia Code/Fall 2022/SOEN 6841 Software Project Management/Projects/medical-assistance-web/src/components/header/header.css", "CSS", 0, 0, 0, 52, 1, 12, 65
"/Users/brijeshlakkad/Documents/Concordia Code/Fall 2022/SOEN 6841 Software Project Management/Projects/medical-assistance-web/src/components/header/header.jsx", "JavaScript React", 0, 0, 26, 0, 1, 1, 28
"/Users/brijeshlakkad/Documents/Concordia Code/Fall 2022/SOEN 6841 Software Project Management/Projects/medical-assistance-web/src/components/landing-page/landing-page.jsx", "JavaScript React", 0, 0, 15, 0, 0, 3, 18
"/Users/brijeshlakkad/Documents/Concordia Code/Fall 2022/SOEN 6841 Software Project Management/Projects/medical-assistance-web/src/components/list-of-doctor/list-of-doctor.css", "CSS", 0, 0, 0, 103, 3, 25, 131
"/Users/brijeshlakkad/Documents/Concordia Code/Fall 2022/SOEN 6841 Software Project Management/Projects/medical-assistance-web/src/components/list-of-doctor/list-of-doctor.jsx", "JavaScript React", 0, 0, 77, 0, 0, 3, 80
"/Users/brijeshlakkad/Documents/Concordia Code/Fall 2022/SOEN 6841 Software Project Management/Projects/medical-assistance-web/src/components/list-of-patient/list-of-patient.css", "CSS", 0, 0, 0, 0, 0, 1, 1
"/Users/brijeshlakkad/Documents/Concordia Code/Fall 2022/SOEN 6841 Software Project Management/Projects/medical-assistance-web/src/components/list-of-patient/list-of-patient.jsx", "JavaScript React", 0, 0, 348, 0, 0, 15, 363
"/Users/brijeshlakkad/Documents/Concordia Code/Fall 2022/SOEN 6841 Software Project Management/Projects/medical-assistance-web/src/components/loading/loading.jsx", "JavaScript React", 0, 0, 11, 0, 0, 3, 14
"/Users/brijeshlakkad/Documents/Concordia Code/Fall 2022/SOEN 6841 Software Project Management/Projects/medical-assistance-web/src/components/make-appointment/make-appointment.css", "CSS", 0, 0, 0, 43, 3, 4, 50
"/Users/brijeshlakkad/Documents/Concordia Code/Fall 2022/SOEN 6841 Software Project Management/Projects/medical-assistance-web/src/components/make-appointment/make-appointment.jsx", "JavaScript React", 0, 0, 119, 0, 4, 5, 128
"/Users/brijeshlakkad/Documents/Concordia Code/Fall 2022/SOEN 6841 Software Project Management/Projects/medical-assistance-web/src/components/pagination/pagination.css", "CSS", 0, 0, 0, 30, 0, 6, 36
"/Users/brijeshlakkad/Documents/Concordia Code/Fall 2022/SOEN 6841 Software Project Management/Projects/medical-assistance-web/src/components/pagination/pagination.jsx", "JavaScript React", 0, 0, 52, 0, 0, 4, 56
"/Users/brijeshlakkad/Documents/Concordia Code/Fall 2022/SOEN 6841 Software Project Management/Projects/medical-assistance-web/src/components/patient-home/patient-home.jsx", "JavaScript React", 0, 0, 6, 0, 0, 1, 7
"/Users/brijeshlakkad/Documents/Concordia Code/Fall 2022/SOEN 6841 Software Project Management/Projects/medical-assistance-web/src/components/patient-info/patient-info.css", "CSS", 0, 0, 0, 36, 1, 1, 38
"/Users/brijeshlakkad/Documents/Concordia Code/Fall 2022/SOEN 6841 Software Project Management/Projects/medical-assistance-web/src/components/patient-info/patient-info.jsx", "JavaScript React", 0, 0, 39, 0, 0, 2, 41
"/Users/brijeshlakkad/Documents/Concordia Code/Fall 2022/SOEN 6841 Software Project Management/Projects/medical-assistance-web/src/components/patient-login/patient-login.css", "CSS", 0, 0, 0, 116, 2, 18, 136
"/Users/brijeshlakkad/Documents/Concordia Code/Fall 2022/SOEN 6841 Software Project Management/Projects/medical-assistance-web/src/components/patient-login/patient-login.jsx", "JavaScript React", 0, 0, 64, 0, 0, 5, 69
"/Users/brijeshlakkad/Documents/Concordia Code/Fall 2022/SOEN 6841 Software Project Management/Projects/medical-assistance-web/src/components/patient-signup/patient-signup.css", "CSS", 0, 0, 0, 121, 4, 20, 145
"/Users/brijeshlakkad/Documents/Concordia Code/Fall 2022/SOEN 6841 Software Project Management/Projects/medical-assistance-web/src/components/patient-signup/patient-signup.jsx", "JavaScript React", 0, 0, 201, 0, 6, 23, 230
"/Users/brijeshlakkad/Documents/Concordia Code/Fall 2022/SOEN 6841 Software Project Management/Projects/medical-assistance-web/src/components/patient-status/patient-status.css", "CSS", 0, 0, 0, 73, 0, 9, 82
"/Users/brijeshlakkad/Documents/Concordia Code/Fall 2022/SOEN 6841 Software Project Management/Projects/medical-assistance-web/src/components/patient-status/patient-status.jsx", "JavaScript React", 0, 0, 177, 0, 4, 8, 189
"/Users/brijeshlakkad/Documents/Concordia Code/Fall 2022/SOEN 6841 Software Project Management/Projects/medical-assistance-web/src/components/reject-modal/reject-modal.css", "CSS", 0, 0, 0, 62, 2, 8, 72
"/Users/brijeshlakkad/Documents/Concordia Code/Fall 2022/SOEN 6841 Software Project Management/Projects/medical-assistance-web/src/components/reject-modal/reject-modal.jsx", "JavaScript React", 0, 0, 41, 0, 0, 6, 47
"/Users/brijeshlakkad/Documents/Concordia Code/Fall 2022/SOEN 6841 Software Project Management/Projects/medical-assistance-web/src/components/signup/counselor-signup.jsx", "JavaScript React", 0, 0, 101, 0, 0, 13, 114
"/Users/brijeshlakkad/Documents/Concordia Code/Fall 2022/SOEN 6841 Software Project Management/Projects/medical-assistance-web/src/components/signup/doctor-signup.jsx", "JavaScript React", 0, 0, 101, 0, 0, 13, 114
"/Users/brijeshlakkad/Documents/Concordia Code/Fall 2022/SOEN 6841 Software Project Management/Projects/medical-assistance-web/src/components/sub-footer/contact-us.jsx", "JavaScript React", 0, 0, 46, 0, 0, 1, 47
"/Users/brijeshlakkad/Documents/Concordia Code/Fall 2022/SOEN 6841 Software Project Management/Projects/medical-assistance-web/src/components/sub-footer/sub-footer.css", "CSS", 0, 0, 0, 88, 0, 18, 106
"/Users/brijeshlakkad/Documents/Concordia Code/Fall 2022/SOEN 6841 Software Project Management/Projects/medical-assistance-web/src/components/sub-footer/sub-footer.jsx", "JavaScript React", 0, 0, 51, 0, 0, 3, 54
"/Users/brijeshlakkad/Documents/Concordia Code/Fall 2022/SOEN 6841 Software Project Management/Projects/medical-assistance-web/src/components/view-assessment/index.css", "CSS", 0, 0, 0, 48, 4, 3, 55
"/Users/brijeshlakkad/Documents/Concordia Code/Fall 2022/SOEN 6841 Software Project Management/Projects/medical-assistance-web/src/components/view-assessment/index.jsx", "JavaScript React", 0, 0, 32, 0, 2, 1, 35
"/Users/brijeshlakkad/Documents/Concordia Code/Fall 2022/SOEN 6841 Software Project Management/Projects/medical-assistance-web/src/components/view-schedule/view-schedule.css", "CSS", 0, 0, 0, 88, 0, 16, 104
"/Users/brijeshlakkad/Documents/Concordia Code/Fall 2022/SOEN 6841 Software Project Management/Projects/medical-assistance-web/src/components/view-schedule/view-schedule.jsx", "JavaScript React", 0, 0, 77, 0, 0, 6, 83
"/Users/brijeshlakkad/Documents/Concordia Code/Fall 2022/SOEN 6841 Software Project Management/Projects/medical-assistance-web/src/containers/assessment-page.jsx", "JavaScript React", 0, 0, 56, 0, 0, 8, 64
"/Users/brijeshlakkad/Documents/Concordia Code/Fall 2022/SOEN 6841 Software Project Management/Projects/medical-assistance-web/src/containers/contact-us.jsx", "JavaScript React", 0, 0, 18, 0, 0, 4, 22
"/Users/brijeshlakkad/Documents/Concordia Code/Fall 2022/SOEN 6841 Software Project Management/Projects/medical-assistance-web/src/containers/counselor-list-of-patient.jsx", "JavaScript React", 0, 0, 68, 0, 0, 13, 81
"/Users/brijeshlakkad/Documents/Concordia Code/Fall 2022/SOEN 6841 Software Project Management/Projects/medical-assistance-web/src/containers/counselor-login-page.jsx", "JavaScript React", 0, 0, 43, 0, 1, 10, 54
"/Users/brijeshlakkad/Documents/Concordia Code/Fall 2022/SOEN 6841 Software Project Management/Projects/medical-assistance-web/src/containers/counselor-make-appointment.jsx", "JavaScript React", 0, 0, 49, 0, 0, 7, 56
"/Users/brijeshlakkad/Documents/Concordia Code/Fall 2022/SOEN 6841 Software Project Management/Projects/medical-assistance-web/src/containers/counselor-patient-details.jsx", "JavaScript React", 0, 0, 6, 0, 0, 1, 7
"/Users/brijeshlakkad/Documents/Concordia Code/Fall 2022/SOEN 6841 Software Project Management/Projects/medical-assistance-web/src/containers/counselor-signup-page.jsx", "JavaScript React", 0, 0, 58, 0, 1, 10, 69
"/Users/brijeshlakkad/Documents/Concordia Code/Fall 2022/SOEN 6841 Software Project Management/Projects/medical-assistance-web/src/containers/counselor-view-schedule.jsx", "JavaScript React", 0, 0, 31, 0, 0, 5, 36
"/Users/brijeshlakkad/Documents/Concordia Code/Fall 2022/SOEN 6841 Software Project Management/Projects/medical-assistance-web/src/containers/doctor-list-of-patient.jsx", "JavaScript React", 0, 0, 59, 0, 0, 11, 70
"/Users/brijeshlakkad/Documents/Concordia Code/Fall 2022/SOEN 6841 Software Project Management/Projects/medical-assistance-web/src/containers/doctor-login-page.jsx", "JavaScript React", 0, 0, 43, 0, 1, 9, 53
"/Users/brijeshlakkad/Documents/Concordia Code/Fall 2022/SOEN 6841 Software Project Management/Projects/medical-assistance-web/src/containers/doctor-make-appointment.jsx", "JavaScript React", 0, 0, 49, 0, 0, 7, 56
"/Users/brijeshlakkad/Documents/Concordia Code/Fall 2022/SOEN 6841 Software Project Management/Projects/medical-assistance-web/src/containers/doctor-patient-details.jsx", "JavaScript React", 0, 0, 6, 0, 0, 1, 7
"/Users/brijeshlakkad/Documents/Concordia Code/Fall 2022/SOEN 6841 Software Project Management/Projects/medical-assistance-web/src/containers/doctor-signup-page.jsx", "JavaScript React", 0, 0, 58, 0, 1, 9, 68
"/Users/brijeshlakkad/Documents/Concordia Code/Fall 2022/SOEN 6841 Software Project Management/Projects/medical-assistance-web/src/containers/doctor-view-schedule.jsx", "JavaScript React", 0, 0, 31, 0, 0, 5, 36
"/Users/brijeshlakkad/Documents/Concordia Code/Fall 2022/SOEN 6841 Software Project Management/Projects/medical-assistance-web/src/containers/error-boundary.jsx", "JavaScript React", 0, 0, 57, 0, 4, 8, 69
"/Users/brijeshlakkad/Documents/Concordia Code/Fall 2022/SOEN 6841 Software Project Management/Projects/medical-assistance-web/src/containers/forward-to-doctor.jsx", "JavaScript React", 0, 0, 56, 0, 0, 11, 67
"/Users/brijeshlakkad/Documents/Concordia Code/Fall 2022/SOEN 6841 Software Project Management/Projects/medical-assistance-web/src/containers/header.jsx", "JavaScript React", 0, 0, 39, 0, 0, 5, 44
"/Users/brijeshlakkad/Documents/Concordia Code/Fall 2022/SOEN 6841 Software Project Management/Projects/medical-assistance-web/src/containers/landing-page.jsx", "JavaScript React", 0, 0, 4, 0, 0, 1, 5
"/Users/brijeshlakkad/Documents/Concordia Code/Fall 2022/SOEN 6841 Software Project Management/Projects/medical-assistance-web/src/containers/patient-details.jsx", "JavaScript React", 0, 0, 41, 0, 0, 3, 44
"/Users/brijeshlakkad/Documents/Concordia Code/Fall 2022/SOEN 6841 Software Project Management/Projects/medical-assistance-web/src/containers/patient-login.jsx", "JavaScript React", 0, 0, 41, 0, 1, 7, 49
"/Users/brijeshlakkad/Documents/Concordia Code/Fall 2022/SOEN 6841 Software Project Management/Projects/medical-assistance-web/src/containers/patient-signup.jsx", "JavaScript React", 0, 0, 57, 0, 1, 9, 67
"/Users/brijeshlakkad/Documents/Concordia Code/Fall 2022/SOEN 6841 Software Project Management/Projects/medical-assistance-web/src/containers/status-page.jsx", "JavaScript React", 0, 0, 27, 0, 0, 5, 32
"/Users/brijeshlakkad/Documents/Concordia Code/Fall 2022/SOEN 6841 Software Project Management/Projects/medical-assistance-web/src/css/colors.js", "JavaScript", 24, 0, 0, 0, 0, 12, 36
"/Users/brijeshlakkad/Documents/Concordia Code/Fall 2022/SOEN 6841 Software Project Management/Projects/medical-assistance-web/src/css/units.js", "JavaScript", 1, 0, 0, 0, 0, 0, 1
"/Users/brijeshlakkad/Documents/Concordia Code/Fall 2022/SOEN 6841 Software Project Management/Projects/medical-assistance-web/src/css/z-index.js", "JavaScript", 1, 0, 0, 0, 0, 1, 2
"/Users/brijeshlakkad/Documents/Concordia Code/Fall 2022/SOEN 6841 Software Project Management/Projects/medical-assistance-web/src/index.css", "CSS", 0, 0, 0, 31, 1, 8, 40
"/Users/brijeshlakkad/Documents/Concordia Code/Fall 2022/SOEN 6841 Software Project Management/Projects/medical-assistance-web/src/index.js", "JavaScript", 10, 0, 0, 0, 3, 6, 19
"/Users/brijeshlakkad/Documents/Concordia Code/Fall 2022/SOEN 6841 Software Project Management/Projects/medical-assistance-web/src/lib/app-state-hoc.jsx", "JavaScript React", 0, 0, 43, 0, 11, 6, 60
"/Users/brijeshlakkad/Documents/Concordia Code/Fall 2022/SOEN 6841 Software Project Management/Projects/medical-assistance-web/src/lib/assessment-questions.js", "JavaScript", 26, 0, 0, 0, 0, 2, 28
"/Users/brijeshlakkad/Documents/Concordia Code/Fall 2022/SOEN 6841 Software Project Management/Projects/medical-assistance-web/src/lib/connected-intl-provider.jsx", "JavaScript React", 0, 0, 8, 0, 0, 3, 11
"/Users/brijeshlakkad/Documents/Concordia Code/Fall 2022/SOEN 6841 Software Project Management/Projects/medical-assistance-web/src/lib/messages.js", "JavaScript", 2, 0, 0, 0, 0, 0, 2
"/Users/brijeshlakkad/Documents/Concordia Code/Fall 2022/SOEN 6841 Software Project Management/Projects/medical-assistance-web/src/lib/path-constants.js", "JavaScript", 25, 0, 0, 0, 4, 5, 34
"/Users/brijeshlakkad/Documents/Concordia Code/Fall 2022/SOEN 6841 Software Project Management/Projects/medical-assistance-web/src/lib/request.js", "JavaScript", 29, 0, 0, 0, 0, 2, 31
"/Users/brijeshlakkad/Documents/Concordia Code/Fall 2022/SOEN 6841 Software Project Management/Projects/medical-assistance-web/src/lib/time-util.js", "JavaScript", 33, 0, 0, 0, 16, 5, 54
"/Users/brijeshlakkad/Documents/Concordia Code/Fall 2022/SOEN 6841 Software Project Management/Projects/medical-assistance-web/src/lib/types.js", "JavaScript", 36, 0, 0, 0, 0, 6, 42
"/Users/brijeshlakkad/Documents/Concordia Code/Fall 2022/SOEN 6841 Software Project Management/Projects/medical-assistance-web/src/logo.svg", "XML", 0, 1, 0, 0, 0, 0, 1
"/Users/brijeshlakkad/Documents/Concordia Code/Fall 2022/SOEN 6841 Software Project Management/Projects/medical-assistance-web/src/reportWebVitals.js", "JavaScript", 12, 0, 0, 0, 0, 2, 14
"/Users/brijeshlakkad/Documents/Concordia Code/Fall 2022/SOEN 6841 Software Project Management/Projects/medical-assistance-web/src/setupTests.js", "JavaScript", 1, 0, 0, 0, 4, 1, 6
"/Users/brijeshlakkad/Documents/Concordia Code/Fall 2022/SOEN 6841 Software Project Management/Projects/medical-assistance-web/src/store/actions/counselor-appointments copy.js", "JavaScript", 88, 0, 0, 0, 3, 4, 95
"/Users/brijeshlakkad/Documents/Concordia Code/Fall 2022/SOEN 6841 Software Project Management/Projects/medical-assistance-web/src/store/actions/counselor-appointments.js", "JavaScript", 88, 0, 0, 0, 3, 4, 95
"/Users/brijeshlakkad/Documents/Concordia Code/Fall 2022/SOEN 6841 Software Project Management/Projects/medical-assistance-web/src/store/actions/counselor-lod.js", "JavaScript", 74, 0, 0, 0, 3, 4, 81
"/Users/brijeshlakkad/Documents/Concordia Code/Fall 2022/SOEN 6841 Software Project Management/Projects/medical-assistance-web/src/store/actions/counselor.js", "JavaScript", 77, 0, 0, 0, 3, 5, 85
"/Users/brijeshlakkad/Documents/Concordia Code/Fall 2022/SOEN 6841 Software Project Management/Projects/medical-assistance-web/src/store/actions/doctor-appointments.js", "JavaScript", 89, 0, 0, 0, 3, 5, 97
"/Users/brijeshlakkad/Documents/Concordia Code/Fall 2022/SOEN 6841 Software Project Management/Projects/medical-assistance-web/src/store/actions/doctor.js", "JavaScript", 77, 0, 0, 0, 3, 5, 85
"/Users/brijeshlakkad/Documents/Concordia Code/Fall 2022/SOEN 6841 Software Project Management/Projects/medical-assistance-web/src/store/actions/locales.js", "JavaScript", 32, 0, 0, 0, 1, 3, 36
"/Users/brijeshlakkad/Documents/Concordia Code/Fall 2022/SOEN 6841 Software Project Management/Projects/medical-assistance-web/src/store/actions/patient.js", "JavaScript", 95, 0, 0, 0, 3, 6, 104
"/Users/brijeshlakkad/Documents/Concordia Code/Fall 2022/SOEN 6841 Software Project Management/Projects/medical-assistance-web/src/store/actions/user.js", "JavaScript", 90, 0, 0, 0, 4, 8, 102
"/Users/brijeshlakkad/Documents/Concordia Code/Fall 2022/SOEN 6841 Software Project Management/Projects/medical-assistance-web/src/store/reducers/counselor-appointments.js", "JavaScript", 101, 0, 0, 0, 0, 2, 103
"/Users/brijeshlakkad/Documents/Concordia Code/Fall 2022/SOEN 6841 Software Project Management/Projects/medical-assistance-web/src/store/reducers/counselor-lod.js", "JavaScript", 96, 0, 0, 0, 0, 3, 99
"/Users/brijeshlakkad/Documents/Concordia Code/Fall 2022/SOEN 6841 Software Project Management/Projects/medical-assistance-web/src/store/reducers/counselor.js", "JavaScript", 101, 0, 0, 0, 0, 3, 104
"/Users/brijeshlakkad/Documents/Concordia Code/Fall 2022/SOEN 6841 Software Project Management/Projects/medical-assistance-web/src/store/reducers/doctor-appointments.js", "JavaScript", 101, 0, 0, 0, 0, 2, 103
"/Users/brijeshlakkad/Documents/Concordia Code/Fall 2022/SOEN 6841 Software Project Management/Projects/medical-assistance-web/src/store/reducers/doctor.js", "JavaScript", 101, 0, 0, 0, 0, 3, 104
"/Users/brijeshlakkad/Documents/Concordia Code/Fall 2022/SOEN 6841 Software Project Management/Projects/medical-assistance-web/src/store/reducers/index.js", "JavaScript", 29, 0, 0, 0, 6, 9, 44
"/Users/brijeshlakkad/Documents/Concordia Code/Fall 2022/SOEN 6841 Software Project Management/Projects/medical-assistance-web/src/store/reducers/locales.js", "JavaScript", 27, 0, 0, 0, 0, 4, 31
"/Users/brijeshlakkad/Documents/Concordia Code/Fall 2022/SOEN 6841 Software Project Management/Projects/medical-assistance-web/src/store/reducers/patient.js", "JavaScript", 82, 0, 0, 0, 0, 3, 85
"/Users/brijeshlakkad/Documents/Concordia Code/Fall 2022/SOEN 6841 Software Project Management/Projects/medical-assistance-web/src/store/reducers/user.js", "JavaScript", 48, 0, 0, 0, 0, 3, 51
"/Users/brijeshlakkad/Documents/Concordia Code/Fall 2022/SOEN 6841 Software Project Management/Projects/medical-assistance-web/src/store/store.js", "JavaScript", 11, 0, 0, 0, 0, 5, 16
"/Users/brijeshlakkad/Documents/Concordia Code/Fall 2022/SOEN 6841 Software Project Management/Projects/medical-assistance-web/src/store/types.js", "JavaScript", 68, 0, 0, 0, 3, 21, 92
"Total", "-", 1798, 1, 3418, 1093, 158, 702, 7170